111111111111111111111111111111
10E0000C0000000000000000111001
111111100000000C00000000111111
111111110000000110000000000C11
111111000000110110000111001111
1P0000000110000010C01001011011
111111111111111111111111111111