11111111111111111111
1P0000000000C0000001
10001111110001111001
1C0000000000N0000001
10111111111111110001
10000000C000000001C1
1N000011110001111101
1000000C00N00C000001
11111000111111111101
1C00000000000000C001
1N000011111111000001
1C0000C0000000C00001
10111110000011111001
1C000000C00000000C01
1N00011111111110E001
11111111111111111111