111111111111111111111111111111
10E000N0000N000000000N00111001
111111100000C0000000C000111111
111111110000000110000000000011
111111000000110101001110011101
1P0000001100000C00000011111111
111111111111111111111111111111