111111111111111111111111111111
10E000000000000000000000111001
111111100000C0000000C000111111
111111110000000110000000000011
111111000000110101001110011101
1P00000011000001C0010011111111
111111111111111111111111111111